VVVVVVVVVVVVVVVVVVVVVVVVVVVVVVVVVVVVVVVVVVVVVVVVVVVVVVVVVVVV
VVVVVVVVVVVVVVVVVVVVVVVVVVVVVVVVVVVVVVVVVVVVVVVVVVVVVVVVVVVV
VVWWWWWWWWWWWWWWWWWWWWWWWWWWWWWWWWWWWWWWWWWWWWWWWWWWWWWWWWVV
VVWAAAAAAAAAAAAAAAAAAAAAAAAAAAAAAAAAAAAAAAAAAAAAAAAAAAAAAWVV
VVWAAAAAAAAAAAAAAAAAAAAAAAAAAAAAAAAAAAAAAAAAAAAAAAAAAAAAAWVV
VVWAAAAAAAAAAAAAAAAAAAAAAAAAAAAAAAAAAAAAAAAAAAAAAAAAAAAAAWVV
VVWAAAWWWWWWWWWWWWWWWWWWWWWAAAAAAWWWWWWWWWWWWWWWWWWWWWAAAWVV
VVWAAAWAAAAAAAAAAAAAAAAAAAWAAAAAAWAAAAAAAAAAAAAAAAAAAWAAAWVV
VVWAAAWAAAAAAAAAAAAAAAAAAAWAAAAAAWAAAAAAAAAAAAAAAAAAAWAAAWVV
VVWAAAWAAAAAAAAAAAAAAAAAAAWAAAAAAWAAAAAAAAAAAAAAAAAAAWAAAWVV
VVWAAAWAAA9999999999999AAAWAAAAAAWAAA9999999999999AAAWAAAWVV
VVWAAAWAAAAAAAAAAAAAAA9AAAWAAAAAAWAAA9AAAAAAAAAAAAAAAWAAAWVV
VVWAAAWAAAAAAAAAAAAAAA9AAAWAAAAAAWAAA9AAAAAAAAAAAAAAAWAAAWVV
VVWAAAWAAAAAAAAAAAAAAA9AAAWAAAAAAWAAA9AAAAAAAAAAAAAAAWAAAWVV
VVWAAAWAAAAAAAAAAAAAAA9AAAWAAAAAAWAAA9AAAAAAAAAAAAAAAWAAAWVV
VVWAAAWAAAAAAAAAAAAAAA9AAAWAAAAAAWAAA9AAAAAAAAAAAAAAAWAAAWVV
VVWAAAWAAAAAAAAAAAAAAA9AAAWAAAAAAWAAA9AAAAAAAAAAAAAAAWAAAWVV
VVWAAAWAAAAAAAAAAAAAAAAAAAAAAAAAAAAAAAAAAAAAAAAAAAAAAWAAAWVV
VVWAAAWAAAAAAAAAAAAAAAAAAAAAAAAAAAAAAAAAAAAAAAAAAAAAAWAAAWVV
VVWAAAWAAAAAAAAAAAAAAAAAAAAAABBAAAAAAAAAAAAAAAAAAAAAAWAAAWVV
VVWAAAWAAAAAAAAAAAAAAAAAAAAAABBAAAAAAAAAAAAAAAAAAAAAAWAAAWVV
VVWAAAWAAAAAAAAAAAAAAAAAAAAAAAAAAAAAAAAAAAAAAAAAAAAAAWAAAWVV
VVWAAAWAAAAAAAAAAAAAAAAAAAAAAAAAAAAAAAAAAAAAAAAAAAAAAWAAAWVV
VVWAAAWAAAAAAAAAAAAAAA9AAAWAAAAAAWAAA9AAAAAAAAAAAAAAAWAAAWVV
VVWAAAWAAAAAAAAAAAAAAA9AAAWAAAAAAWAAA9AAAAAAAAAAAAAAAWAAAWVV
VVWAAAWAAAAAAAAAAAAAAA9AAAWAAAAAAWAAA9AAAAAAAAAAAAAAAWAAAWVV
VVWAAAWAAAAAAAAAAAAAAA9AAAWAAAAAAWAAA9AAAAAAAAAAAAAAAWAAAWVV
VVWAAAWAAAAAAAAAAAAAAA9AAAWAAAAAAWAAA9AAAAAAAAAAAAAAAWAAAWVV
VVWAAAWAAAAAAAAAAAAAAA9AAAWAAAAAAWAAA9AAAAAAAAAAAAAAAWAAAWVV
VVWAAAWAAA9999999999999AAAWAAAAAAWAAA9999999999999AAAWAAAWVV
VVWAAAWAAAAAAAAAAAAAAAAAAAWAAAAAAWAAAAAAAAAAAAAAAAAAAWAAAWVV
VVWAAAWAAAAAAAAAAAAAAAAAAAWAAAAAAWAAAAAAAAAAAAAAAAAAAWAAAWVV
VVWAAAWAAAAAAAAAAAAAAAAAAAWAAAAAAWAAAAAAAAAAAAAAAAAAAWAAAWVV
VVWAAAWWWWWWWWWWWWWWWWWWWWWAAAAAAWWWWWWWWWWWWWWWWWWWWWAAAWVV
VVWAAAAAAAAAAAAAAAAAAAAAAAAAAAAAAAAAAAAAAAAAAAAAAAAAAAAAAWVV
VVWAAAAAAAAAAAAAAAAAAAAAAAAAAAAAAAAAAAAAAAAAAAAAAAAAAAAAAWVV
VVWAAAAAAAAAAAAAAAAAAAAAAAAAAAAAAAAAAAAAAAAAAAAAAAAAAAAAAWVV
VVWWWWWWWWWWWWWWWWWWWWWWWWWWWWWWWWWWWWWWWWWWWWWWWWWWWWWWWWVV
VVVVVVVVVVVVVVVVVVVVVVVVVVVVVVVVVVVVVVVVVVVVVVVVVVVVVVVVVVVV
VVVVVVVVVVVVVVVVVVVVVVVVVVVVVVVVVVVVVVVVVVVVVVVVVVVVVVVVVVVV