VVVVVVVVVVVVVVVVVVVVVVVVVVVVVVVVVVVVVVVVVVVVVVVVVVVVVVVVVVVV
VVVVVVVVVVVVVVVVVVVVVVVVVVVVVVVVVVVVVVVVVVVVVVVVVVVVVVVVVVVV
VVWWWWWWWWWWWWWWWWWWWWWWWWWWWWWWWWWWWWWWWWWWWWWWWWWWWWWWWWVV
VVWAAAAAAAAAAAAAAAAAAAAAAAAAAAAAAAAAAAAAAAAAAAAAAAAAAAAAAWVV
VVWAAAAAAAAAAAAAAAAAAAAAAAAAAAAAAAAAAAAAAAAAAAAAAAAAAAAAAWVV
VVWAAAAAAAAAAAAAAAAAAAAAAAAAAAAAAAAAAAAAAAAAAAAAAAAAAAAAAWVV
VVWAAAAAAAAAAAAWWAAWWAAAAAAAAAAAAAAAAAAWWAAWWAAAAAAAAAAAAWVV
VVWAAAAAAAAAAAWWAAAAWWAAAAAAAAAAAAAAAAWWAAAAWWAAAAAAAAAAAWVV
VVWAAAAAAAAAAWWAAAAAAWWAAAAAAAAAAAAAAWWAAAAAAWWAAAAAAAAAAWVV
VVWAAAAAAAAAWWAAAAAAAAWWAAAAAAAAAAAAWWAAAAAAAAWWAAAAAAAAAWVV
VVWAAAAAAAA99AAAAAAAAAA99AAAAAAAAAA99AAAAAAAAAA99AAAAAAAAWVV
VVWAAAAAAA99AAAAAAAAAAAA99AAAAAAAA99AAAAAAAAAAAA99AAAAAAAWVV
VVWAAAAAA99AAAAAAAAAAAAAA99AAAAAA99AAAAAAAAAAAAAA99AAAAAAWVV
VVWAAAAAWWAAAAAAAAAAAAAAAAWWAAAAWWAAAAAAAAAAAAAAAAWWAAAAAWVV
VVWAAAAWWAAAAAAAAAAAAAAAAAAWWAAWWAAAAAAAAAAAAAAAAAAWWAAAAWVV
VVWAAAWWAAAAAAAAAAAAAAAAAAAAWWWWAAAAAAAAAAAAAAAAAAAAWWAAAWVV
VVWAAWWAAAAAAAAAAAAAAAAAAAAAAWWAAAAAAAAAAAAAAAAAAAAAAWWAAWVV
VVWAAWAAAAAAAAAAAAAAAAAAAAAAAAAAAAAAAAAAAAAAAAAAAAAAAAWAAWVV
VVWAAAAAAAAAAAAAAAAAAAAAAAAAAAAAAAAAAAAAAAAAAAAAAAAAAAAAAWVV
VVWAAAAAAAAAAAAAAAAAAAAAAAAAABBAAAAAAAAAAAAAAAAAAAAAAAAAAWVV
VVWAAWAAAAAAAAAAAAAAAAAAAAAAABBAAAAAAAAAAAAAAAAAAAAAAAWAAWVV
VVWAAWWWAAAAAAAAAAAAAAAAAAAAAAAAAAAAAAAAAAAAAAAAAAAAWWWAAWVV
VVWAAAAWWAAAAAAAAAAAAAAAAAAAAAAAAAAAAAAAAAAAAAAAAAAWWAAAAWVV
VVWAAAAAWWWAAAAAAAAAAAAAAAAAAAAAAAAAAAAAAAAAAAAAAWWWAAAAAWVV
VVWAAAAAAAWWAAAAAAAAAAAAAAAAAAAAAAAAAAAAAAAAAAAAWWAAAAAAAWVV
VVWAAAAAAAA999AAAAAAAAAAAAAAAAAAAAAAAAAAAAAAAA999AAAAAAAAWVV
VVWAAAAAAAAAA99AAAAAAAAAAAAAAAAAAAAAAAAAAAAAA99AAAAAAAAAAWVV
VVWAAAAAAAAAAA999AAAAAAAAAAAAAAAAAAAAAAAAAA999AAAAAAAAAAAWVV
VVWAAAAAAAAAAAAAWWAAAAAAAAAAAAAAAAAAAAAAAAWWAAAAAAAAAAAAAWVV
VVWAAAAAAAAAAAAAAWWWAAAAAAAAAAAAAAAAAAAAWWWAAAAAAAAAAAAAAWVV
VVWAAAAAAAAAAAAAAAAWWAAAAAAAAAAAAAAAAAAWWAAAAAAAAAAAAAAAAWVV
VVWAAAAAAAAAAAAAAAAAWWWAAAAAAAAAAAAAAWWWAAAAAAAAAAAAAAAAAWVV
VVWAAAAAAAAAAAAAAAAAAAWWAAAAAAAAAAAAWWAAAAAAAAAAAAAAAAAAAWVV
VVWAAAAAAAAAAAAAAAAAAAAWWWAAAAAAAAWWWAAAAAAAAAAAAAAAAAAAAWVV
VVWAAAAAAAAAAAAAAAAAAAAAAWWAAAAAAWWAAAAAAAAAAAAAAAAAAAAAAWVV
VVWAAAAAAAAAAAAAAAAAAAAAAAAAAAAAAAAAAAAAAAAAAAAAAAAAAAAAAWVV
VVWAAAAAAAAAAAAAAAAAAAAAAAAAAAAAAAAAAAAAAAAAAAAAAAAAAAAAAWVV
VVWWWWWWWWWWWWWWWWWWWWWWWWWWWWWWWWWWWWWWWWWWWWWWWWWWWWWWWWVV
VVVVVVVVVVVVVVVVVVVVVVVVVVVVVVVVVVVVVVVVVVVVVVVVVVVVVVVVVVVV
VVVVVVVVVVVVVVVVVVVVVVVVVVVVVVVVVVVVVVVVVVVVVVVVVVVVVVVVVVVV