WWWWWWWWWWWWWWWWWWWWWWWWWWWWWWWWWWWWWWWWWWWWWWWWWWWWWWWWWWWW
WWWWWWWWWWWWWWWWWWWWWWWWWWWWWWWWWWWWWWWWWWWWWWWWWWWWWWWWWWWW
WWWWWWWWWWWWWWWWWWWWWWWWWWWWWWWWWWWWWWWWWWWWWWWWWWWWWWWWWWWW
WWWAAAAAAAAAAAAAAAAAAAAAAAAAAAAAAAAAAAAAAAAAAAAAAAAAAAAAAWWW
WWWAAAAAAAAAAAAAAAAAAAAAAAAAAAAAAAAAAAAAAAAAAAAAAAAAAAAAAWWW
WWWAA9999999AAAAAAAAAAAAAAAAAAAAAAAAAAAAAAAAAAAA9999999AAWWW
WWWAA9AAAAAAAAAAAAAAAAAAAAA9AAAA9AAAAAAAAAAAAAAAAAAAAA9AAWWW
WWWAA9AAAAAAAAAAAAAAAAAAAAA99AA99AAAAAAAAAAAAAAAAAAAAA9AAWWW
WWWAA9AAAAAAAAAAAAAAAAAAAAAA9AA9AAAAAAAAAAAAAAAAAAAAAA9AAWWW
WWWAA9AAAAAAAAAAAAAAAAAAAAAA9AA9AAAAAAAAAAAAAAAAAAAAAA9AAWWW
WWWAA9AAAAAAAAAAAAAAAAAAAAAA9AA9AAAAAAAAAAAAAAAAAAAAAA9AAWWW
WWWAA9AAAAAAAAAAAAAAAAAAAAAA9AA9AAAAAAAAAAAAAAAAAAAAAA9AAWWW
WWWAAAAAAAAAAAAAAAAAAAAAAAAA9AA9AAAAAAAAAAAAAAAAAAAAAAAAAWWW
WWWAAAAAAAAAAAAAAAAAAAAAAAA99AA99AAAAAAAAAAAAAAAAAAAAAAAAWWW
WWWAAAAAAAAAAAAAAAAAAAAAAA99AAAA99AAAAAAAWWAAAAAAAAAAAAAAWWW
WWWAAAAAAAAAAAAWWAAAAAAAA99AAAAAA99AAAAAAAWWAAAAAAAAAAAAAWWW
WWWAAAAAAAAAAAWWAAAAAAAA99AAAAAAAA99AAAAAAAWWAAAAAAAAAAAAWWW
WWWAAAAAAAAAAAWAAAAAAAA99AAAAAAAAAA99AAAA9AAWAAAAAAAAAAAAWWW
WWWAAAAAAAAAAAWAAAAAAA99AAAAAAAAAAAA99AAAAAWWAAAAAAAAAAAAWWW
WWWAAAAAAAAAAAWWAAAAAA9AAAAAA99AAAAAA9AAAAWWAAAAAAAAAAAAAWWW
WWWAAAAAAAAAAAAWWAAAAA9AAAAAA99AAAAAA9AAAWWAAAAAAAAAAAAAAWWW
WWWAAAAAAAAAAAAAAAAAAA99AAAAAAAAAAAA99AAAAAAAAAAAAAAAAAAAWWW
WWWAAAAAAAAAAAAAAAAAAAA99AAAAAAAAAA99AAAAAAAAAAAAAAAAAAAAWWW
WWWAAAAAAAAAAAAAAAAAAAAA99AAAAAAAA99AAAAAAAAAAAAAAAAAAAAAWWW
WWWAAAAAAAAAAAAAAAAAAAAAA99AAAAAA99AAAAAAAAAAAAAAAAAAAAAAWWW
WWWAAAAAAAAAAAAAAAAAAAAAAA99AAAA99AAAAAAAAAAAAAAAAAAAAAAAWWW
WWWAAAAAAAAAAAAAAAAAAAAAAAA99AA99AAAAAAAAAAAAAAAAAAAAAAAAWWW
WWWAAAAAAAAAAAAAAAAAAAAAAAAA9AA9AAAAAAAAAAAAAAAAAAAAAAAAAWWW
WWWAA9AAAAAAAAAAAAAAAAAAAAAA9AA9AAAAAAAAAAAAAAAAAAAAA9AAAWWW
WWWAA9AAAAAAAAAAAAAAAAAAAAAA9AA9AAAAAAAAAAAAAAAAAAAAA9AAAWWW
WWWAA9AAAAAAAAAAAAAAAAAAAAAA9AA9AAAAAAAAAAAAAAAAAAAAA9AAAWWW
WWWAA9AAAAAAAAAAAAAAAAAAAAAA9AA9AAAAAAAAAAAAAAAAAAAAA9AAAWWW
WWWAA9AAAAAAAAAAAAAAAAAAAAA99AA99AAAAAAAAAAAAAAAAAAAA9AAAWWW
WWWAA9AAAAAAAAAAAAAAAAAAAAA9AAAA9AAAAAAAAAAAAAAAAAAAA9AAAWWW
WWWAA9999999AAAAAAAAAAAAAAAAAAAAAAAAAAAAAAAAAAA9999999AAAWWW
WWWAAAAAAAAAAAAAAAAAAAAAAAAAAAAAAAAAAAAAAAAAAAAAAAAAAAAAAWWW
WWWAAAAAAAAAAAAAAAAAAAAAAAAAAAAAAAAAAAAAAAAAAAAAAAAAAAAAWWWW
WWWWWWWWWWWWWWWWWWWWWWWWWWWWWWWWWWWWWWWWWWWWWWWWWWWWWWWWWWWW
WWWWWWWWWWWWWWWWWWWWWWWWWWWWWWWWWWWWWWWWWWWWWWWWWWWWWWWWWWWW
WWWWWWWWWWWWWWWWWWWWWWWWWWWWWWWWWWWWWWWWWWWWWWWWWWWWWWWWWWWW