VVVVVVVVVVVVVVVVVVVVVVVVVVVVVVVVVVVVVVVVVVVVVVVVVVVVVVVVVVVV
VVVVVVVVVVVVVVVVVVVVVVVVVVVVVVVVVVVVVVVVVVVVVVVVVVVVVVVVVVVV
VVWWWWWWWWWWWWWWWWWWWWWWWWWWWWWWWWWWWWWWWWWWWWWWWWWWWWWWWWVV
VVWAAAAAAAAAAAAAAAAAAAAAAAAAAAAAAAAAAAAAAAAAAAAAAAAAAAAAAWVV
VVWAAAAAAAAAAAAAAAAAAAAAAAAAAAAAAAAAAAAAAAAAAAAAAAAAAAAAAWVV
VVWAA9999999AAAAAAAAAAAAAAAAAAAAAAAAAAAAAAAAAAAA9999999AAWVV
VVWAA9AAAAAAAAAAAAAAAAAAAAAAAAAAAAAAAAAAAAAAAAAAAAAAAA9AAWVV
VVWAA9AAAAAAAAAAAAAAAAAAAAAA9AA9AAAAAAAAAAAAAAAAAAAAAA9AAWVV
VVWAA9AAWWWWWWWAAAAAAAAAAAAA9AA9AAAAAAAAAAAAAWWWWWWWAA9AAWVV
VVWAA9AAWAAAAAAAAAAAAAAAAAAA9AA9AAAAAAAAAAAAAAAAAAAWAA9AAWVV
VVWAA9AAWAAAAAAAAAAAAAAAAAAA9AA9AAAAAAAAAAAAAAAAAAAWAA9AAWVV
VVWAA9AAWAAAAAAAAAAAAAAAAAAA9AA9AAAAAAAAAAAAAAAAAAAWAA9AAWVV
VVWAAAAAWAAAAAAAAAAAAAAAAAAA9AA9AAAAAAAAAAAAAAAAAAAWAAAAAWVV
VVWAAAAAWAAAAAAAAAAAAAAAAAA99AA99AAAAAAAAAAAAAAAAAAWAAAAAWVV
VVWAAAAAWAAAAAAAAAAAAAAAAA99AAAA99AAAAAAAAAAAAAAAAAWAAAAAWVV
VVWAAAAAAAAAAAAAAAAAAAAAA99AAAAAA99AAAAAAAAAAAAAAAAAAAAAAWVV
VVWAAAAAAAAAAAAAAAAAAAAA99AAAAAAAA99AAAAAAAAAAAAAAAAAAAAAWVV
VVWAAAAAAAAAAAAAAAAAA9999AAAAAAAAAA9999AAAAAAAAAAAAAAAAAAWVV
VVWAAAAAAAAAAAAAAAAAAAAAAAAAAAAAAAAAAAAAAAAAAAAAAAAAAAAAAWVV
VVWAAAAAAAAAAAAAAAAAAAAAAAAAABBAAAAAAAAAAAAAAAAAAAAAAAAAAWVV
VVWAAAAAAAAAAAAAAAAAAAAAAAAAABBAAAAAAAAAAAAAAAAAAAAAAAAAAWVV
VVWAAAAAAAAAAAAAAAAAAAAAAAAAAAAAAAAAAAAAAAAAAAAAAAAAAAAAAWVV
VVWAAAAAAAAAAAAAAAAAA9999AAAAAAAAAA9999AAAAAAAAAAAAAAAAAAWVV
VVWAAAAAAAAAAAAAAAAAAAAA99AAAAAAAA99AAAAAAAAAAAAAAAAAAAAAWVV
VVWAAAAAAAAAAAAAAAAAAAAAA99AAAAAA99AAAAAAAAAAAAAAAAAAAAAAWVV
VVWAAAAAWAAAAAAAAAAAAAAAAA99AAAA99AAAAAAAAAAAAAAAAWAAAAAAWVV
VVWAAAAAWAAAAAAAAAAAAAAAAAA99AA99AAAAAAAAAAAAAAAAAWAAAAAAWVV
VVWAAAAAWAAAAAAAAAAAAAAAAAAA9AA9AAAAAAAAAAAAAAAAAAWAAAAAAWVV
VVWAA9AAWAAAAAAAAAAAAAAAAAAA9AA9AAAAAAAAAAAAAAAAAAWAA9AAAWVV
VVWAA9AAWAAAAAAAAAAAAAAAAAAA9AA9AAAAAAAAAAAAAAAAAAWAA9AAAWVV
VVWAA9AAWAAAAAAAAAAAAAAAAAAA9AA9AAAAAAAAAAAAAAAAAAWAA9AAAWVV
VVWAA9AAWWWWWWWAAAAAAAAAAAAA9AA9AAAAAAAAAAAAWWWWWWWAA9AAAWVV
VVWAA9AAAAAAAAAAAAAAAAAAAAAA9AA9AAAAAAAAAAAAAAAAAAAAA9AAAWVV
VVWAA9AAAAAAAAAAAAAAAAAAAAAAAAAAAAAAAAAAAAAAAAAAAAAAA9AAAWVV
VVWAA9999999AAAAAAAAAAAAAAAAAAAAAAAAAAAAAAAAAAA9999999AAAWVV
VVWAAAAAAAAAAAAAAAAAAAAAAAAAAAAAAAAAAAAAAAAAAAAAAAAAAAAAAWVV
VVWAAAAAAAAAAAAAAAAAAAAAAAAAAAAAAAAAAAAAAAAAAAAAAAAAAAAAAWVV
VVWWWWWWWWWWWWWWWWWWWWWWWWWWWWWWWWWWWWWWWWWWWWWWWWWWWWWWWWVV
VVVVVVVVVVVVVVVVVVVVVVVVVVVVVVVVVVVVVVVVVVVVVVVVVVVVVVVVVVVV
VVVVVVVVVVVVVVVVVVVVVVVVVVVVVVVVVVVVVVVVVVVVVVVVVVVVVVVVVVVV