WWWWWWWWWWWWWWWWWWWWWWWWWWWWWWWWWWWWWWWWWWWWWWWWWWWWWWWWWWWW
WAAABAAAAAAAAAAAAAAAAAAAAAAAAAAAAAAAAAAAAAAAAAAAAAAAAAAAAAAW
WAAAAAAAAAAAAAAAAAAAAAAAAABAAAAAAAAAAAAAAAAAAAAAAAAAAAAAAAAW
WAAAAAAAAAAAAAAAAAAAAAAAAAAAAAAAAAAAAAAAAAAAAAAAAAAAAAAAAAAW
WAAAAAAAAABAAAAAAAAAAAAAAAAABAAAAAAAAAAAAAAAAAAAAAAAAAAAAAAW
WAAAAAAAAAAAAAAAAAAAAAAAAAAAAAAAAAAAAAAAAAAAAAAAAAAAAAAAAAAW
WAAAAAAAAAAAAAAAAAAAAAAAAAAAAAAAAAAAAAAAAAAAAAAAAAAAAAAAAAAW
WAAAAAAAAAAAAAAAABAAAAAAAAAAAAAAAAAAAAA99999999AAAAAAAAAAAAW
WAAAAAAAAAAAAAAAAAAAAAAAAAAAAAAAAAAAAAA99999999AAAAAAAAAAAAW
WAAAAAAAAAAAAWWWWWWWWWAAAAAAAAAAAAAAAAA99999999AAAAAAAAAAAAW
WAAAAAAAAAAAAAAAAAAWAAAAAAAAAAAAAAAAAAA99999999AAAAAAAAAAAAW
WAAAAAAAAAAAAAAAAAAWAAAAAAAAAAAAAAAAAAA99999999AAAAAAAAAAAAW
WAAAAAAAAAAAAAAAAAAWAAAAAAAABAAAAAAAAAA99999999AAAAAAAAAAAAW
WAAAAAAAAAAAAAAAAAAWAAAAAAAAAAAAAAAAAAAAAAAAAAAAAAAAAAAAAAAW
WAAAAAAAAAABAAAAAAAWAAAAAAAWWWWWWWAAAAAAAAAAAAAAAAAAAAAAAAAW
WAAAAAAAAAAAAAAAAAAWAAAAAAAAAAAAAAAAAAAAAAAAAAAAAAAAAAAAAAAW
WAAAAAAAAAAAAAAAAAAAAAAAAAAAAAAAAAAAAAAAAAAAAAAAAAAAAAAAAAAW
WAAAAAAAAAAAAAAAAAAAAAAAAAWWAAAAAAAAAAAAAAAAAAAAAAAAAAAAAAAW
WAAAAAAAAAAAAAAAAAAAAAAAAAWWAAAAAAAAAAAAAAAAAAAAAAAAAAAAAAAW
WAAAAAAAAAAAAAAAAAAAAAAAAAAAAAABAAAAAAAAAAAAAAAAAAAAAAAAAAAW
WAAAAAAAAAAAAAAAAAAAAAAAAAAAAAAAAAAAAAAAAAAAAAAAAAAAAAAAAAAW
WAAABAAAAAABAAAAAAAAAAAAAAAAAAAAAAAAAAAAAAAAAAAAAAAAAAAAAAAW
WAAAAABAAAAAAABAAAAABAAAAAAAAAAAAAAAAAAAAAAAAAAAAAAAAAAAAAAW
WAABAAAAAAAAAAAAABAAAAABAAAAAAAAAAAAAAAAAAAAAAAAAAAAAAAAAAAW
WAAAAAAAAAAAAAAAAAAAAAAAAAAAAAAAAAAAAAAAAAAAAAAAAAAAAAAAAAAW
WAAAAAAAAAAAAAAAAAAAAAAAAAAAAAAAAAAAAAAAAAAAAAAAAAAAAAAAAAAW
WAAAAAAAAAAAAAAAAAAAAAAAAAAAAAAAAAAAAAAAAAAAAAAAAAAAAAAAAAAW
WAAAAAAAAAAAAAAAAAAAAAAAAAAAAAAAAAAAAAAAAAAAAAAAAAAAAAAAAAAW
WAAAAAAAAAAAAAAAAAAAAAAAAAAAAAAAAAAAAAAAAAAAAAAAAAAAAAAAAAAW
WAAAAAAAAAAAAAAAAAAAAAAAAAAAAAAAAAAAAAAAAAAAAAAAAAAAAAAAAAAW
WAAAAAAAAAAAAAAAAAAAAAAAAAAAAAAAAAAAAAAAAAAAAAAAAAAAAAAAAAAW
WAAAAAAAAAAAAAAAAAAAAAAAAAAAAAAAAAAAAAAAAAAAAAAAAAAAAAAAAAAW
WAAAAAAAAAAAAAAAAAAAAAAAAAAAAAAAAAAAAAAAAAAAAAAAAAAAAAAAAAAW
WAAAAAAAAAAAAAAAAAAAAAAAAAAAAAAAAAAAAAAAAAAAAAAAAAAAAAAAAAAW
WAAAAAAAAAAAAAAAAAAAAAAAAAAAAAAAAAAAAAAAAAAAAAAAAAAAAAAAAAAW
WAAAAAAAAAAAAAAAAAAAAAAAAAAAAAAAAAAAAAAAAAAAAAAAAAAAAAAAAAAW
WAAAAAAAAAAAAAAAAAAAAAAAAAAAAAAAAAAAAAAAAAAAAAAAAAAAAAAAAAAW
WAAAAAAAAAAAAAAAAAAAAAAAAAAAAAAAAAAAAAAAAAAAAAAAAAAAAAAAAAAW
WAAAAAAAAAAAAAAAAAAAAAAAAAAAAAAAAAAAAAAAAAAAAAAAAAAAAAAAAAAW
WWWWWWWWWWWWWWWWWWWWWWWWWWWWWWWWWWWWWWWWWWWWWWWWWWWWWWWWWWWW